11111111111111111111111111111111111111111
10101000000010000010000000100000000010001
10101110111010111011101110111010111010101
10000000100010001000101010001010101000101
11111111101111101110101311101110101111101
10000000101000000010001000100000100010001
11101111101111111011111110111111101110111
10100000100000100010000000000010000000001
10101110111110101111101111101010111111111
10101000000010001000001000001010000000001
10101011101111111011111111111011111111101
10001000101000000000000000100000100010001
10111110101011111111111110111110111010111
10100000101000000000101010000010000010001
11101111101111111110101011111011111111101
10001000100010000000100000001000000010001
10111010111110111111101111111111111010111
10000010000000100010100000000010100010001
10111111111111101010111111111010101110111
10100000001000001000000000000000100010001
10101111101011111111111111111110111010111
00100000100010000010001000000010100010001
10111110111110111010101011111010101111101
10000000100000001000100000001000100000002
11111111111111111111111111111111111111111
