1111111111111111111111
1000000000100000000001
1000000000100003000001
1000000000100000000001
1000000000000000000001
1000000000000000000001
1111211111111111111111
