11111111111111
1            1
111111 11111 1
1    1 13    1
1111 1 11111 1
12       1   1
11111111111111
